1111111111111111111
100P100000000010001
10010000000C0011101
1000000011111111111
1001000000000110101
1000000000000C00E01
1111111111111111111